#	ABR	<unknown>
Un	ABR	<unknown>
titre	NOM	titre
Un	VER:subi	<unknown>
vrai	ADJ	vrai
bout-en-train	NOM	<unknown>
.	SENT	.
L'	DET:ART	le
été	NOM	été
tout	ADV	tout
ça	PRO:DEM	cela
l’	NOM	<unknown>
avale	VER:pres	avaler
«	PUN:cit	«
direct	ADJ	direct
»	PUN:cit	»
et	KON	et
"	PUN:cit	"
directe	ADJ	direct
"	PUN:cit	"
.	SENT	.
Pourrais	VER:cond	pouvoir
-je	PRO:PER	je
voir	VER:infi	voir
n'	ADV	ne
est	VER:pres	être
-ce	PRO:DEM	ce
pas	NOM	pas
un	DET:ART	un
poids	NOM	poids
mi-lourd	ADJ	mi-lourd
?	SENT	?
