Cette	PRO:DEM	ce
première	NUM	premier
proximité	NOM	proximité
doit	VER:pres	devoir
entrer	VER:infi	entrer
en	PRP	en
proximité	NOM	proximité
avec	PRP	avec
cette	PRO:DEM	ce
troisième	NUM	troisième
proximité	NOM	proximité
une	DET:ART	un
fois	NOM	foi|fois
que	KON	que
le	DET:ART	le
deuxième	NUM	deuxième
terme	NOM	terme
est	VER:pres	être
supprimé	VER:pper	supprimer
.	SENT	.
